NO textures/wall_1.xpm
SO textures/wall_2.xpm
WE textures/wall_3.xpm
EA textures/wall_4.xpm

F 184,113,39
C 51,198,227


11111111111111111111111111111
10000000001101000000000000001
N0000000000100000001010000001
11111111111111111111111111111
