NO ./textures/greystone.xpm
SO ./textures/purplestone.xpm
EA ./textures/wood.xpm
WE ./textures/redbrick.xpm

F 77,92,53
C 163,208,230

        1111111111111111111111111
        1000000000110000000000001
        1011000001110000000000001
        100101111111111100000000111111
11111111101101101110001111111111
1000000000110111111011111111111
1111011111111111111111111111111
111101111111111111111111010001
11000000110101011100000010001
10000000000000001100000010001
10000000000000001101010010001
11000001110101011111011110N0111
11110011111010111101111010001
11111111111111111111111111111
