NO textures/Wall_NO1.xpm
SO textures/Wall_SO1.xpm
WE textures/Wall_WE1.xpm
EA textures/Wall_EA1.xpm

F 184,113,39
C 51,198,12


11111111111111111111111111111
100001  101101000000000000001
1000N1  100100000001010000001
11111111111111111111111111111
11111111111111111111111111111