NO textures/wall_1.xpm
SO textures/wall_2.xpm
WE textures/wall_3.xpm
EA textures/wall_4.xpm

F 184,113,39
C 51,198,227


11111
1S001
10001
10001
11111