EA textures/Wall_EA.xpm
SO textures/Wall_SO.xpm
WE textures/Wall_WE.xpm
NO textures/Wall_NO.xpm
C 51,198,227

F 184,113,39

  111111111111111111
  1 1100000000000001
 1010011100000011111
 10001   11000001
 1000011100000011
 100000N00000001
 111111111111111